470300006
062950407
008004012
910200000
004060001
007005000
000409050
340701000
090000000